###############################
#  #         ####    $#       #
#  #$   $    #    #   # ###   #
#  # #####   #  ###   #  $#   #
#  #   #   O #  #     #  #    #
#  #   #$   ##  #  O  #  #    #
#  ## ####   #  # #####  #  * #
#        #      #        #    #
###############################
