   ############################
#  #         ####    $#       #
#  #$   $    #    #   # ###   #
#  ## ####  $#  ###   #   #   #
#  #   #   % #  #     #  #    #
#  #   #     #  #     #  #    #
#  ## ####   #  # #####  #  * #
#        #      #        #    #
###############################
